Primer	Chromosome	Midpoint	SNP_ID	SNP_Position	Distance
PsUF1_CHS_U	PS_chr01	1119339802	AX-602014067	1118289015	1050787
PtNCS_1C3A_U	PS_chr01	910302708	AX-601102513	910299607	3101
PtNCS_1C3A_L	PS_chr01	910302979	AX-601102513	910299607	3372
PtNCS_p14A9_U	PS_chr03	467650748	AX-388228804	467650866	118
PtIPST_pLP2_L	PS_chr03	51761843	AX-389151890	51761607	236
PtIPST_pLP2_L	PS_chr10	643057460	AX-601553651	643113697	56237
PtIPST_pLP2_L	PS_chr12	558872963	AX-612724784	558862505	10458
PsTUB_GapC1_U	PS_chr02	246545713	AX-613473271	248303003	1757290
PsTUB_GapC1_L	PS_chr01	1469610361	AX-602784400	1467712463	1897898
PsTUB_GapC1_L	PS_chr02	246399015	AX-613473271	248303003	1903988
PsTUB_GapC1_L	PS_chr02	246551840	AX-613473271	248303003	1751163
PtMTU_lpPAL_L	PS_chr10	391426840	AX-600220071	391482390	55550
PtMTU_lpPAL_L	PS_chr10	391436032	AX-600220071	391482390	46358
PtMTU_lp4CL-2_U	PS_chr04	602172946	AX-605300226	602828524	655578
PtMTU_lp4CL-2_L	PS_chr04	602171665	AX-605300226	602828524	656859
PsARI_dehydrin_L	PS_chr08	280000439	AX-601779839	280080042	79603
PtNCS_HLH1_L	PS_chr08	29353007	AX-601850766	29352382	625
PtWS1_PCBER-PT1_U	PS_chr04	1029381385	AX-601825716	1029468551	87166
PtWS1_PCBER-PT1_U	PS_chr08	142715916	AX-612274666	142729188	13272
PtWS1_PCBER-PT1_U	PS_chr08	142735612	AX-612274666	142729188	6424
PtWS1_PCBER-PT1_U	PS_chr08	143135983	AX-612274666	142729188	406795
PtWS1_PCBER-PT1_U	PS_chr08	325735270	AX-388577305	325843814	108544
PtWS1_PCBER-PT1_L	PS_chr08	142715409	AX-612274666	142729188	13779
PtWS1_PCBER-PT1_L	PS_chr08	142856579	AX-612274666	142729188	127391
PsUPS1_PHY_U	PS_chr01	1701213051	AX-387688622	1701209806	3245
PsUPS1_PHY_U	PS_chr06	381461738	AX-600427046	381012363	449375
PsUPS1_PHY_L	PS_chr08	634662385	AX-601240850	634396330	266055
PsUOU_adhF_U	PS_chr06	1063293226	AX-606063714	1063235216	58010
PsUMU_plNEab21_L	PS_chr06	833728633	AX-599842233	833728540	93
PsUPS2_PST13_L	PS_chr12	255842109	AX-600302169	255845255	3146
PtNCS_4C1C_U	PS_chr08	1228583755	AX-601123365	1228086386	497369
PsUF2_NIR_U	PS_chr04	269433651	AX-388330182	269433507	144
PsUF2_NIR_U	PS_chr04	269601934	AX-388330182	269433507	168427
